# Romaji to Stable IPA mapping
# Format: romaji=ipa
# Source: allosaurus_rex/phoneme_map.py ROMAJI_TO_IPA
a=a
i=i
u=ɯ
e=e
o=o
N=ɴ
k=k
g=ɡ
s=s
z=z
t=t
d=d
n=n
h=h
f=ɸ
b=b
p=p
m=m
y=j
r=ɾ
l=ɾ
w=w
v=v
'=ʔ
br=br
sh=ɕ
ch=tɕ
ts=ts
j=dʑ
dj=dʑ
ky=kʲ
gy=ɡʲ
hy=ç
by=bʲ
py=pʲ
my=mʲ
ny=nʲ
ry=ɾʲ
sil=sil
_=sil
sp=sil
SP=sil
<unk>=sil
